00000000P
100010101
10C0z0001
00000C001
1P0C000E1
110111111