1111111111
111100E001
10P1000C01
1111000001
1111111111