11111111
1E000001 
1C000C01      
1P000101      
100001C1           
11111111