1111111111111111111111111111111111
1E0000000000000C00000C000000000001
1010010100100O00101001000O00010101
1010010010101010001001000000010101
1P0000000C00C00000O00000000O0001C1
1111111111111111111111111111111111