111111111
10O00O0E1
1C00000C1
1P0O00C11
111111111