1111111111
1P0O0C00C1
1000110O01
10C011O001
10O0C000E1
1111111111