1111111111
1P000C00C1
1000110001
10C0110001
1000C000E1
1111111111